Date,Mainland China,Other locations,Total,plusNum,plusPercentNum
2020-04-22 22:00:00,82790,2490427,2573217,76191,0.030512697905428297
2020-04-21 22:00:00,82779,2414247,2497026,76191,0.030512697905428297
2020-04-20 22:00:00,82747,2336573,2419320,76191,0.030512697905428297
2020-04-19 22:00:00,82735,2263676,2346411,76191,0.030512697905428297
2020-04-18 22:00:00,82719,2181197,2263916,76191,0.030512697905428297
2020-04-17 22:00:00,82692,2090641,2173333,76191,0.030512697905428297
2020-04-16 22:00:00,82666,1996673,2079339,76191,0.030512697905428297
2020-04-15 22:00:00,82295,1916523,1998818,76191,0.030512697905428297
2020-04-14 22:00:00,82250,1838771,1921021,76191,0.030512697905428297
2020-04-13 22:00:00,82160,1769160,1851320,76191,0.030512697905428297
2020-04-12 22:00:00,82052,1697143,1779195,76191,0.030512697905428297
2020-04-11 22:00:00,81970,1617323,1699293,76191,0.030512697905428297
2020-04-10 22:00:00,81907,1523606,1605513,76191,0.030512697905428297
2020-04-09 22:00:00,81865,1435372,1517237,76191,0.030512697905428297
2020-04-08 22:00:00,81805,1355174,1436979,76191,0.030512697905428297
2020-04-07 22:00:00,81740,1271415,1353155,76191,0.030512697905428297
2020-04-06 22:00:00,81708,1199646,1281354,76191,0.030512697905428297
2020-04-05 22:00:00,81669,1127691,1209360,76191,0.030512697905428297
2020-04-04 21:00:00,81639,1043987,1125626,76191,0.030512697905428297
2020-04-03 21:00:00,81614,948624,1030238,76191,0.030512697905428297
2020-04-02 21:00:00,81589,870200,951789,76191,0.030512697905428297
2020-04-01 21:00:00,81540,792428,873968,76191,0.030512697905428297
2020-03-31 21:00:00,81513,718528,800041,76191,0.030512697905428297
2020-03-30 21:00:00,81479,653914,735393,76191,0.030512697905428297
2020-03-29 21:00:00,81443,597167,678610,76191,0.030512697905428297
2020-03-28 21:00:00,81400,533023,614423,76191,0.030512697905428297
2020-03-27 21:10:00,81341,461492,542833,76191,0.030512697905428297
2020-03-26 22:20:00,81255,406786,488041,76191,0.030512697905428297
2020-03-25 23:20:00,81221,355495,436716,76191,0.030512697905428297
2020-03-24 21:20:00,81167,311191,392358,76191,0.030512697905428297
2020-03-23 21:40:00,81116,268675,349791,76191,0.030512697905428297
2020-03-22 21:00:00,81057,227665,308722,76191,0.030512697905428297
2020-03-21 21:00:00,81013,201679,282692,76191,0.030512697905428297
2020-03-20 21:20:00,80977,171008,251985,76191,0.030512697905428297
2020-03-19 21:30:00,80929,142103,223032,76191,0.030512697905428297
2020-03-18 22:00:00,80906,122679,203585,76191,0.030512697905428297
2020-03-17 21:00:00,80883,103227,184110,76191,0.030512697905428297
2020-03-16 21:00:00,80866,90230,171096,76191,0.030512697905428297
2020-03-15 21:00:00,80838,76976,157814,76191,0.030512697905428297
2020-03-14 21:00:00,80824,66993,147817,76191,0.030512697905428297
2020-03-13 21:00:00,80801,55045,135846,76191,0.030512697905428297
2020-03-12 21:00:00,80793,46941,127734,76191,0.030512697905428297
2020-03-11 21:00:00,80778,39836,120614,76191,0.030512697905428297
2020-03-10 21:00:00,80754,33923,114677,76191,0.030512697905428297
2020-03-09 21:00:00,80735,30540,111275,76191,0.030512697905428297
2020-03-08 21:00:00,80695,26550,107245,76191,0.030512697905428297
2020-03-07 21:00:00,80651,21943,102594,76191,0.030512697905428297
2020-03-06 21:00:00,80551,18371,98922,76191,0.030512697905428297
2020-03-05 21:00:00,80408,15815,96223,76191,0.030512697905428297
2020-03-04 21:00:00,80266,13288,93554,76191,0.030512697905428297
2020-03-03 21:00:00,80151,12024,92175,76191,0.030512697905428297
2020-03-02 21:00:00,80026,9744,89770,76191,0.030512697905428297
2020-03-01 21:00:00,79823,7161,86984,76191,0.030512697905428297
2020-02-29 21:00:00,79251,6421,85672,76191,0.030512697905428297
2020-02-28 21:00:00,78824,5036,83860,76191,0.030512697905428297
2020-02-27 21:00:00,78497,4001,82498,76191,0.030512697905428297
2020-02-26 21:00:00,78064,3157,81221,76191,0.030512697905428297
2020-02-25 21:00:00,77660,2667,80327,76191,0.030512697905428297
2020-02-24 21:00:00,77150,2360,79510,76191,0.030512697905428297
2020-02-23 21:00:00,76936,1948,78884,76191,0.030512697905428297
2020-02-22 21:00:00,76291,1634,77925,76191,0.030512697905428297
2020-02-21 21:00:00,75247,1337,76584,76191,0.030512697905428297
2020-02-20 21:00:00,74578,1183,75761,76191,0.030512697905428297
2020-02-19 21:00:00,74184,1106,75290,76191,0.030512697905428297
2020-02-18 21:00:00,72438,986,73424,76191,0.030512697905428297
2020-02-17 21:00:00,70553,889,71442,76191,0.030512697905428297
2020-02-16 21:00:00,68507,775,69282,76191,0.030512697905428297
2020-02-15 21:00:00,66496,689,67185,76191,0.030512697905428297
2020-02-14 21:00:00,63862,591,64453,76191,0.030512697905428297
2020-02-13 21:00:00,59822,572,60394,76191,0.030512697905428297
2020-02-12 21:00:00,44685,522,45207,76191,0.030512697905428297
2020-02-11 20:30:00,42658,473,43131,76191,0.030512697905428297
2020-02-10 21:00:00,40195,452,40647,76191,0.030512697905428297
2020-02-09 21:00:00,37230,370,37600,76191,0.030512697905428297
2020-02-08 21:00:00,34609,347,34956,76191,0.030512697905428297
2020-02-07 21:00:00,31187,321,31508,76191,0.030512697905428297
2020-02-06 21:00:00,28085,263,28348,76191,0.030512697905428297
2020-02-05 21:00:00,24385,231,24616,76191,0.030512697905428297
2020-02-04 20:00:00,20483,194,20677,76191,0.030512697905428297
2020-02-03 20:00:00,17302,181,17483,76191,0.030512697905428297
2020-02-02 20:00:00,14451,177,14628,76191,0.030512697905428297
2020-02-01 10:00:00,11221,153,11374,76191,0.030512697905428297
2020-01-31 12:30:00,9658,117,9775,76191,0.030512697905428297
2020-01-30 12:00:00,7678,105,7783,76191,0.030512697905428297
2020-01-29 14:00:00,5970,87,6057,76191,0.030512697905428297
2020-01-28 11:30:00,4409,64,4473,76191,0.030512697905428297
2020-01-27 14:00:00,2737,57,2794,76191,0.030512697905428297
2020-01-26 13:00:00,1979,40,2019,76191,0.030512697905428297
2020-01-25 15:00:00,1320,37,1357,76191,0.030512697905428297
2020-01-24 15:00:00,865,16,881,76191,0.030512697905428297
2020-01-23 15:00:00,639,15,654,76191,0.030512697905428297
2020-01-22 15:00:00,549,6,555,76191,0.030512697905428297
2020-01-21 15:00:00,327,5,332,76191,0.030512697905428297
